Saro and Šmuni are neighbours.	I Saro w i Šmuni jirane ne.	18364.mp3
From time to time they go shopping, swimming or to something else together.	Me zabno l zabno konëfqi cam ḥḏoḏe li šuqo, lu sḥoyo aw l mede ḥreno.	18365.mp3
Tomorrow is Friday.	Ramḥël yawme dë cruto yo.	18366.mp3
They are both off, they do not have to work.	At tarte baṭile ne, lo kolozam d cawdi.	18367.mp3
Because they would like to enjoy their time off, they make a date to go swimming.	Lašan d mašëfci u yawmaṯṯe u xalyo basimo, kosaymi wacdo cam ḥḏoḏe d ëzzën lu sḥoyo.	18368.mp3
Saro: Šmuni, what are you going to do tomorrow? If you like we can go swimming.	Šmuni, mën gëd saymat ramḥël? D ëbcat kiban ëzzan lu sḥoyo.	18370.mp3
Šmuni: Sure, that is a good idea. I have nothing planned.	Ašër rënyo ṭawwo yo. Latli mede lë syomo.	18371.mp3
Šmuni: What is the weather like?	I hawa aydarbo yo?	18372.mp3
Saro: The weather is good. It is going to be 25°C.	I hawa ṭawto yo. Gëd huwyo ḥamšo w cësri (25) darġe.	18373.mp3
Šmuni: What time would you like us to go?	I saca bak kmo këbcat ëzzan?	18374.mp3
Saro: We can go early. Is ten o'clock OK?	Kiban ḥeloyo ëzzan. Bac csar ṭawwo yo?	18375.mp3
Šmuni: Yes, that is good. What are we going to do there all day?	E, ṭawwo yo. Mën gëd saymina u yawmo kule tamo?	18376.mp3
Saro: We will swim, we will sunbathe, we will have coffee, and at noontime, around 12:30 we will have lunch. This is how we will spend our day.	Gëd soḥina, gëd mšamsina, gëd šotina qaḥwe w falge d yawmo laf i saca tracsar w falge gëd macrina. Hawxa gëd šofac u yawmayḏan.	18377.mp3
Šmuni: Sounds good. When shall we come back home?	Šafiro. Bak kmo këbcat ducrina?	18378.mp3
Saro: Around 4 pm, 4:30 pm. I will have to prepare dinner, because Aday comes from work at 6 pm.	Laf i saca arbac, arbac w falge. Kolozam mḥaḏrono i ḥšamto, miḏe du Aday baš šeṯ koṯe mu cwodo.	18379.mp3
Šmuni: Ok, as you like. No problem.	Ṭrowe xud këbcat. Layt qëṭro.	18380.mp3
Saro: What are you going to do this evening? Let's have coffee at our place.	Adyawma caṣriye mën gëd saymitu? Toxu šotina qaḥwe sidan.	18381.mp3
Šmuni: Let's see, if Afrem does not have any appointments or anything else to do, we will come.	Ḥozina, iḏa u Afrem latle wacde aw mede lë syomo, gëd oṯina.	18382.mp3
Saro: Great, bye, see you in the evening.	Šafiro, fëš bë šlomo, hul adcaṣriye.	18383.mp3
Šmuni: See you later.	Zax bë šlomo.	18384.mp3
